32,32,32,32,32,32,32,0,0,0,0,0,0,0,0,0,0,0,0,0,0,0,0,0,0,0,0,0,0,0,0,0,0,0,0,0,0,0,0,0,0,0,0,0,0,0,0,0,0,0,
32,0,0,0,0,0,32,0,0,0,0,0,0,0,0,0,0,0,0,0,0,0,0,0,0,0,0,0,0,0,0,0,0,0,0,0,0,0,0,0,0,0,0,0,0,0,0,0,0,0,
32,0,0,0,0,0,32,0,0,0,0,0,0,0,0,0,0,0,0,0,0,0,0,0,0,0,0,0,0,0,0,0,0,0,0,0,0,0,0,0,0,0,0,0,0,0,0,0,0,0,
32,0,0,0,0,0,32,0,0,0,0,0,0,0,0,0,0,0,0,0,32,32,32,32,32,32,32,32,32,0,0,0,0,0,0,0,0,0,0,0,0,0,0,0,0,0,0,0,0,0,
32,0,0,0,0,0,32,0,0,0,0,0,0,0,0,0,0,0,0,0,32,0,0,0,0,0,0,0,32,0,0,0,0,0,0,0,0,0,0,0,0,0,0,0,0,0,0,0,0,0,
32,0,0,32,32,32,32,0,0,0,0,0,0,0,0,0,0,0,0,0,32,0,0,0,0,0,0,0,32,0,0,0,0,0,0,0,0,0,0,0,0,0,0,0,0,0,0,0,0,0,
32,0,0,32,0,0,0,0,0,0,0,0,0,0,0,0,0,0,0,0,32,0,0,32,32,32,32,32,32,0,0,0,0,0,0,0,32,32,32,32,32,32,32,32,0,0,0,0,0,0,
32,0,0,32,0,0,0,0,0,0,0,0,0,0,0,0,0,0,0,31,32,0,0,32,0,0,0,0,0,0,0,0,0,0,0,0,32,0,0,0,0,0,0,32,0,0,0,0,0,0,
32,0,0,32,0,0,0,0,0,32,32,32,32,32,32,32,32,32,0,31,32,0,0,32,0,0,0,0,0,0,0,0,0,0,0,0,32,0,0,0,0,0,0,32,0,0,0,0,0,0,
32,0,0,32,0,0,0,0,31,32,0,0,0,0,0,0,0,32,32,32,32,0,0,32,0,0,0,0,0,0,0,0,0,0,0,0,32,0,0,0,0,0,0,32,0,32,32,32,32,0,
32,0,0,32,0,0,0,0,31,32,0,0,0,0,0,0,0,0,0,0,0,0,0,32,32,32,32,32,32,32,0,0,0,0,0,0,32,0,0,0,0,0,0,32,0,32,0,0,32,0,
32,0,0,32,0,0,0,0,0,32,0,0,0,0,0,0,0,0,0,0,0,0,0,0,0,0,0,0,0,32,32,32,32,32,32,32,32,0,0,0,0,0,0,32,32,32,0,0,32,0,
32,0,0,32,0,0,0,0,0,32,0,0,0,0,0,0,0,32,32,32,32,32,31,31,0,0,0,0,0,0,0,0,0,0,0,0,0,0,0,0,0,0,0,0,0,0,0,0,32,0,
32,0,0,32,0,0,0,0,0,32,0,0,0,0,0,0,0,32,0,0,0,32,32,32,32,32,32,0,0,0,0,0,0,0,0,0,0,0,0,0,0,0,0,0,0,0,0,0,32,0,
32,0,0,32,32,32,0,0,0,32,32,32,32,32,32,32,32,32,0,0,0,0,0,0,0,0,32,32,32,32,32,32,32,32,32,32,32,32,32,32,32,32,32,32,32,32,0,0,32,0,
32,0,0,32,0,32,0,0,0,0,0,0,0,0,0,0,0,0,0,0,0,0,0,0,0,0,0,0,0,0,0,0,0,0,0,0,0,0,0,0,0,0,0,0,0,32,0,0,32,0,
32,0,0,32,0,32,0,0,0,0,0,0,0,0,0,0,0,0,0,0,0,0,0,0,0,0,0,0,0,0,0,0,0,0,0,0,0,0,0,0,0,0,0,0,0,32,0,0,32,0,
32,0,0,0,0,32,0,0,0,0,0,0,0,32,32,32,32,0,0,0,0,32,32,32,32,32,32,0,0,0,0,0,0,0,0,0,32,32,32,32,32,32,0,0,0,32,0,0,32,0,
32,0,0,0,0,32,0,0,0,0,0,0,0,32,0,0,32,0,0,0,0,32,0,0,0,0,32,32,32,32,32,32,32,32,32,32,32,32,32,32,32,32,32,32,32,32,0,0,32,0,
32,32,32,0,0,32,32,32,32,32,32,32,32,32,0,0,32,32,32,32,32,32,0,0,0,0,0,0,0,0,0,0,0,0,0,0,0,0,0,0,0,0,0,0,0,0,0,0,32,0,
0,0,32,0,0,0,0,0,0,0,0,0,0,0,0,0,0,0,0,0,0,0,0,0,0,0,0,0,0,0,0,0,0,0,0,0,0,0,32,32,0,0,0,0,0,0,0,0,32,0,
0,0,32,0,0,0,0,0,0,0,0,0,0,0,0,0,0,0,0,0,0,0,0,0,0,0,32,32,32,32,32,0,0,32,32,32,32,0,0,0,0,32,32,32,32,32,32,32,32,0,
0,0,32,32,32,32,32,32,0,0,32,32,32,32,32,32,32,32,32,32,32,32,0,0,0,0,32,0,0,0,32,0,0,32,0,0,32,0,0,0,0,32,0,0,0,0,0,0,0,0,
0,0,0,0,0,0,0,32,0,0,32,0,0,0,0,0,0,0,0,0,0,32,32,32,32,32,32,0,0,0,32,0,0,32,0,0,32,0,0,0,0,32,0,0,0,0,0,0,0,0,
0,0,32,32,32,32,32,32,0,0,32,0,0,0,0,0,0,0,0,0,0,0,0,0,0,0,0,0,0,0,32,0,0,32,0,0,32,0,0,0,0,32,0,0,0,0,0,0,0,0,
0,0,32,0,0,0,0,0,0,0,32,0,0,0,0,0,0,0,0,0,0,0,0,0,0,0,0,0,0,0,32,0,0,32,0,0,32,32,32,32,32,32,0,0,0,0,0,0,0,0,
0,0,32,0,0,0,0,0,0,0,32,0,0,0,0,0,0,0,0,0,0,32,32,32,32,32,32,32,32,32,32,0,0,32,32,32,32,32,32,32,32,32,32,0,0,0,0,0,0,0,
0,0,32,32,32,32,32,32,0,0,32,0,0,0,0,0,0,0,0,0,0,32,0,0,0,0,0,0,0,0,0,0,0,0,0,0,0,0,0,0,0,0,32,0,0,0,0,0,0,0,
0,0,0,0,0,0,0,32,0,0,32,32,0,0,0,0,0,0,0,0,0,32,0,0,0,0,0,0,0,0,0,0,0,0,0,0,0,0,0,0,0,0,32,0,0,0,0,0,0,0,
0,0,0,0,0,0,0,32,0,0,0,32,32,0,0,0,0,0,0,0,0,32,0,0,32,32,32,0,0,0,0,0,0,32,32,32,32,32,32,32,0,0,32,0,0,0,0,0,0,0,
0,0,0,0,0,0,0,32,0,0,0,0,32,32,0,0,0,0,0,0,0,32,0,0,32,32,32,0,0,0,0,0,0,32,32,32,32,32,32,32,0,0,32,0,0,0,0,0,0,0,
0,0,0,0,0,0,0,32,0,0,0,0,0,32,32,0,0,0,0,0,0,32,0,0,0,0,0,0,0,0,0,0,0,0,0,0,0,0,0,0,0,0,32,0,0,0,0,0,0,0,
0,0,0,0,0,0,0,32,0,0,0,0,0,0,32,32,0,0,0,0,0,32,0,0,0,0,0,0,0,0,0,0,0,0,0,0,0,0,0,0,0,0,32,0,0,0,0,0,0,0,
0,0,0,0,0,0,0,32,0,0,0,0,0,0,0,32,0,0,0,0,0,32,32,32,32,32,32,32,32,32,32,32,32,32,32,32,32,32,32,32,32,32,32,0,0,0,0,0,0,0,
0,0,0,0,0,0,0,32,0,0,0,0,0,0,0,32,0,0,0,0,0,0,0,0,0,0,0,0,0,0,0,0,0,0,0,0,0,0,0,0,0,0,0,0,0,0,0,0,0,0,
0,0,0,0,0,0,0,32,0,0,32,32,32,32,32,32,0,0,0,0,0,0,0,0,0,0,0,0,0,0,0,0,0,0,0,0,0,0,0,0,0,32,32,32,32,32,32,32,32,32,
0,0,0,0,0,0,0,32,0,0,32,0,0,0,0,0,0,0,32,32,32,32,0,0,0,0,0,0,0,0,0,32,32,32,32,32,32,0,0,0,0,32,0,0,0,0,0,0,0,32,
0,0,0,0,0,0,0,32,0,0,32,0,0,0,0,0,0,0,32,0,0,32,0,0,0,0,0,0,0,0,0,32,0,0,0,0,32,0,0,0,0,32,0,0,0,0,0,0,0,32,
0,0,0,0,0,0,0,32,0,0,32,32,32,32,32,32,32,32,32,0,0,32,32,32,32,32,32,32,32,32,32,32,0,0,0,0,32,32,32,32,32,32,0,0,0,0,0,0,0,32,
0,0,0,0,0,0,0,32,0,0,0,0,0,0,0,0,0,0,0,0,0,0,0,0,0,0,0,0,0,0,0,0,0,0,0,0,0,0,0,0,0,0,0,0,0,0,0,0,0,32,
0,0,0,0,0,0,0,32,0,0,0,0,0,0,0,0,0,0,0,0,0,0,0,0,0,0,0,0,0,0,0,0,0,0,0,0,0,0,0,0,0,0,0,0,0,0,0,0,0,32,
0,0,0,0,0,0,0,32,0,0,0,0,0,0,32,32,32,32,32,32,32,32,0,0,0,32,32,32,32,32,32,32,0,0,0,0,32,32,32,32,32,32,0,0,0,0,0,0,0,32,
0,0,0,0,0,0,0,32,0,0,32,32,0,0,32,0,0,0,0,0,0,32,0,0,0,32,0,0,0,0,0,32,0,0,0,0,32,0,0,0,0,32,0,0,0,0,0,0,0,32,
0,0,0,0,0,0,0,32,0,0,32,32,32,32,32,0,0,0,0,0,0,32,0,0,0,32,0,0,0,0,0,32,32,32,32,32,32,0,0,0,0,32,0,0,0,0,0,0,0,32,
0,0,0,0,0,0,0,32,32,32,32,0,0,0,0,0,0,0,0,0,0,32,0,0,0,32,0,0,0,0,0,0,0,0,0,0,0,0,0,0,0,32,32,32,32,32,32,32,32,32,
0,0,0,0,0,0,0,0,0,0,0,0,0,0,0,0,0,0,0,0,0,32,0,0,0,32,0,0,0,0,0,0,0,0,0,0,0,0,0,0,0,0,0,0,0,0,0,0,0,0,
0,0,0,0,0,0,0,0,0,0,0,0,0,0,0,0,0,0,0,0,0,32,0,0,0,32,0,0,0,0,0,0,0,0,0,0,0,0,0,0,0,0,0,0,0,0,0,0,0,0,
0,0,0,0,0,0,0,0,0,0,0,0,0,0,0,0,0,0,0,0,0,32,0,0,0,32,0,0,0,0,0,0,0,0,0,0,0,0,0,0,0,0,0,0,0,0,0,0,0,0,
0,0,0,0,0,0,0,0,0,0,0,0,0,0,0,0,0,0,0,0,0,32,32,32,32,32,0,0,0,0,0,0,0,0,0,0,0,0,0,0,0,0,0,0,0,0,0,0,0,0,
0,0,0,0,0,0,0,0,0,0,0,0,0,0,0,0,0,0,0,0,0,0,0,0,0,0,0,0,0,0,0,0,0,0,0,0,0,0,0,0,0,0,0,0,0,0,0,0,0,0